1111111111111111111111111000100010001101000101010111000101010000101000001011001010001111010111110101101111111100000010000010110001000100111111011101011110111011000100000100001100010001101110111011111110111110100001001000000011000100000111110101110101111010111110000010010010110001010001111111101011011011101010100000010100101100000001010101111011110111111110101010000101000011010000010001111010101111101011111111100000010000110101000000010111111111011010111101111000001000001100010000100101110101011111111011110111100011100011001000001000010101011101101111110101011010101000110000000000100001000101001111111111111111111111111
1111111111111111111111111000010001101000010000100111101010000101101111011011010111101010100100001001101000000100011010110001110111011011111000010010011010001000000111111101101100010111111010100010100111111000001000010111011111000001111110101000100001111110100010010111011111110001011100011000001000011110001000100111110101111100011111111110001010000111100000010000010101111011000110100010101000000001111001011111110111111111110000100100100001000001011011111000111110110111101100001001001000010000010111110101111101111110100011000010100010000100011111101111010101101010100010110000100010010100010100001111111111111111111111111
1111111111111111111111111001000100000010000100000110101010111101111011111011010101010000100001000001100010001011110110101110111101111100000010000001011000101000111111101111101101110111010000010100000110000010001111101010111111111101011100010001000101100000100010111011111010111111011101000100100001011000101000001011110111101101010111111100001000000110100000010011110101111111011111101100010010000001100001000100100011111010111110111011111100100001011000010001000010110111111101111011101111001000000110110000010010101111111111001111111101000010000001101100010000101111011111110000100011010000000000001111111111111111111111111
1111111111111111111111111001000101000001000101000110101010001010101000111011010101111101000101010001100010000010111111101011111111110101010000100100011010000010001111010111101101011111011100001000000110100001000010101111111011000110111101010000010001111110010000101111111011110100011011110101000100011000100100000000101111101101111111111111010000100110001000100101000011110111010101010110111101001001101000100000010000001111110111111111111111110010011010000000000000101011011100011111111101000100000111111000100000111111111011000101010111110001000101101110101000100010101010110000010001000101000100001111111111111111111111111
1111111111111111111111111000000100001000101000010111111011110101000111101011001001000011111010000101110101101101000101011110110010000100001000000000011011111011111111111111101100000001000100000100000110111111101010111110111111000010000101000001000001111101011111111110111110110000100000000001000000011011111111111110101111111100100010100000010000010111010100000111111111101011001011111000010000010101101101000111101111101010110000101010000100000100011111110101011111111011111101000010100000100000000110111101010111110101111111010000100000001010000001101111011111110101111110110000000000010000100000001111111111111111111111111
1111111111111111111111111001000100010001000001000110101010100010111110101111010100011111010001010001100010111000100010001110111111010001011111110100011000001011111000000000101111110100000111011111111110000011111000000100010011011111000101111110101101100001001110000000010100111110110001110111111000111001010010000001000101001110101111111110101011111110010000010000010100010011011111101011111110101011100000000100000000010000111111111110111111111110111000001000000100010000001111010001111011101011111110101111100001000100000011010010011101111011111101100011011000100000100010110100100001000101010100001111111111111111111111111
1111111111111111111111111000010000100000100000010111101111010111010111111011000000001010000010000001101111110101011111011111110100001010101000100010011000110100010101010101011101111111111000100010000110100000000001111111111111010111111110100010000001101000000001010101011110110111111110101010101010011010000000010001000101011101011111111011111110000110101000101000000010011111000001000101111101101011101111111111100000100000110100000000010111110101011000101111111000001111101111110000000101111100000110001111111010001011111111010100000001010000001001101010111111111111010110110100000000000000101000001111111111111111111111111
1111111111111111111111111000000001000010000000000110111110111101111101011111001000010000100000100001110101011011110111111110111010100000001000100000011000011111101111011111101101111000010000001010000110100001011011111101011111011111100100001000100001101000000111111101111110110001111001000010000010011111100110101111111101011100011010000000001000100110111001111111110101111111000101100010000010000101111000000101011111111010110001111110100010000001011111100001000101010101101101000110111110101010000110101110000001000101111111010001010101111110100001101011111110001010000101110000000001010000011010001111111111111111111111111
1111111111111111111111111000001010000010000010100111110101111101111101011011000010101010100000101001111011000001010111110101110100001110001010000000011011111101110101111101101100000000000010000010010110111111011111111101101011000000100000000000000101111101011111111111111110110000100000000000000000011011111111111011111101111100000000000101000010100111111111111110101111011011000000100000000100001001111110110111111110111101110001001000000010000000011110110111111101111111111100010000010000101000000110111111101011010101011111000100000101000000100101111010111110101111111010110000000000010000001000001111111111111111111111111
1111111111111111111111111000010100010101000101010111101000100010001000101011000101111101111110110001101010101010101000001110110100010101010101011100011011111000100000100010111100000001111111111101000111110111100000000100001111001001000111111010111101101110101110000101000000110000010000011010001111111011111111111101111100001100000000000010000000111111111010111101010111110011000001010000101000001011101111101011110111110101110000010100000010001010011011111011111111010101101101010001010000001010000110101010101011111101111111010001010100010010100001101111111010101011010111110000000000010100000000001111111111111111111111111
1111111111111111111111111001000000000000000001010110101111111111111010001011010100010001000101111101101010101010101000000000110000010101010101111111011011111010100010001000001100010100010111110101111110101011111010000010000011010101000001011111111101101000001111101000000000110111111100010101111111111000000000101010001000001111111111010101010101111110010000001000101010100011101011111111111101010101100100010000000000101110110110101011111111110001011000010100010001000010001111111000100010101111011110000001111111010100101011011111100010101010110001101000010101010101000011110001100010001000101100001111111111111111111111111
1111111111111111111111111000000001000100001001010111111010101010101110101011000001000100010000010101101111111111111011111010110000000000000100000001011111111111111011111110101100000001000000000100000110111110101111101000111111000001010000010111110001111110101011111000000010110000010000000111111111011111101111111110001000001100000000000001010001010110111111111111111111111111000001000000100000000001111110101111010111111110110001010000101010000001011110101011110000011110101100000000001011101000010110111111111101000101111011000001000000101110000101111110101111010001111010110000010100001010100000001111111111111111111111111
1111111111111111111111111000000010000000010000100111111101010111101011111011000000001010000000001001101111111101011111101101110100000000101000010000011010111111110110101011111101000000000010010100000110001111101111011011111011111100010100001001000001100000100010111101101111110111111111000010000100011000000000001111111010101111111111110100000101011110010001000000111010001011011010101111110001111101100101010000000010000000111010101011111111111111111001010000000100010000001101101111111010111010110110000001000001000001010011111110101111101110101011100001010001000100010101110110000010001010101010001111111111111111111111111
1111111111111111111111111001000000010000001010000110101111101011111101010111010001000100000000101001101011101010111010110101110000010101000101000010011111101010111010101111011100000101010001010000100110101110111011101111111011010100000000010100000001101011111111101010111111110100010100010101000000011010100000101010111111101101011111110101010000000110101000001000001011111111010111110111111101010001101010000000000000101110110101011101010111110000011010001000101000000010111101110101011111111111010110100010101000010000001011010101010001011011110001101010101011101101000011110001010100010010101100001111111111111111111111111
1111111111111111111111111000010000001000000000010110101011101111111011101011010101010000000001000101101000101111111010101110110111110100000001010000011000000010111111101111111111111011010000100100000110100001000010110110111011010111101111011000000101100000000100000111111010111111111011111110000001011000000100000000011111101101111011111111101000000110100000000000000101111111010111111111111010000001111000000010100001111011110101111101011110000101011010100000100001111010101100010111110110000001010111111000000010010101100011000001111101011111110111101011100010100010001000110100000101010100010101001111111111111111111111111
1111111111111111111111111000010000000010101000010110101010111111010111101011010101010000001010000101101010101011111100010110110100010101000010111000011011111000001111010001111100000101110100101011100111111011100010110101000111000100000111000010101111111010111010001111010100110000000100010100001010111011111111111110101100001100000000010000010000110111111111101011111111111111010000000100000000000001101011111010111111111110110101000001010000001010011000101111101011110101011111110000000100001010100110000011111110110101011111011111000000001010000001101000001011111101111111110001010100000010000000001111111111111111111111111
1111111111111111111111111001000100010001000101000110001010101011101010001011111101010100010101101111100000001010100010100000110111111101111111011111011000010010001000100010001111101101010101010101011110000100101000100010000011111010111111111111011111101001010001000000100000110101100010001111010111111010000111110100000010101100011110000010111111000111111001011111010000001011010001100000100011010101101110011011111011111111110100000001000000100010011011111110101111110101101100001000010001001010100111110101111110110101000111000010001000010000111111101111110101111011110000110000000010000000000011001111111111111111111111111
1111111111111111111111111001000001000010000000000110111110111101111101111011010000010000100010100001100010111011010101011101110111000001000010101000111000111111111111000101001111010101000000111110101110000010101011110001010011011111000100000010101101100000101111011101000010111111010000100011111111011010001111011101000100001101010000001000111010111110101111111101000101000011010010000011111010101111101101011111000001000000110000000010111110111111011101111101010001000000001100100010101011101111110111010101000100010001010011001010111111101110101011101101000100010100010101110000101000101000101000001111111111111111111111111
1111111111111111111111111000100010010100000001000111010111101010111110101011001001000101000001000101101110101000111110101110110000000111010000010010011111111010000011111101101101000001011111000000100110101111100100101111110111010000011111010000100001101110100000001111010111110000011111110001001000011111101001010010101111101101000101101011010010000110111000010000101101011111010001111111110000100101100010000010001111111110111111111101110100000000011010001000100010111011111101010101010101000100010110001000100010001010101011011111111111111101010001101000100010001000111111110001000101010001000000001111111111111111111111111
1111111111111111111111111001000100000100010000100110001000101000101111011011111111110111110100101001100000001010101000110101110111100000000111110010011000100101010110000011101101111111101000010100000110001000010111111111111011110111101010100000100101100010000101011111010110110100011000000010001001011011111111111101011110001100001000100010101010011111110111010100000101011011000000101010111110000001111111010101010001011111110000101000111110100000011011110111001000000101111100001000110111111110100111110101110010001000010111010000001101010101111011101010101100101010100000110001010010110100000101001111111111111111111111111
1111111111111111111111111001010100010001000100010110101000101010101010101011010001010101000101010101100011111010111010001010111111000000000101111100011000101111111110100000101111010101000000010111110110000010101011111001000011111101000100000001101111100010101111111110010000111101010010100001101111111000001101011010000000001101111100001001011011111110000100111111100100000011111011000000011010111111100000001111111001010000111101110100010101111111011010101010101000001000001100010100010001111101111110111011111110100010100011000001000101010100010101111010101010100010101010110001000100010101010001001111111111111111111111111